{
  "levels": [
    {
      "name": "Level 1: Original",
      "map": [
        ["x", "o", "x", "o", "x", "o", "x", "o", "x", "o", "x", "o", "x", "o", "x"],
        ["o", "x", "o", "x", "o", "x", "o", "x", "o", "x", "o", "x", "o", "x", "o"],
        ["x", "o", "x", "o", "x", "o", "x", "o", "x", "o", "x", "o", "x", "o", "x"],
        ["o", "x", "o", "x", "o", "x", "o", "x", "o", "x", "o", "x", "o", "x", "o"],
        ["x", "o", "x", "o", "x", "o", "x", "o", "x", "o", "x", "o", "x", "o", "x"],
        ["o", "x", "o", "x", "o", "x", "o", "x", "o", "x", "o", "x", "o", "x", "o"],
        ["x", "o", "x", "o", "x", "o", "x", "o", "x", "o", "x", "o", "x", "o", "x"],
        ["o", "o", "o", "o", "o", "o", "o", "o", "o", "o", "o", "o", "o", "o", "o"],
        ["o", "o", "o", "o", "o", "o", "o", "o", "o", "o", "o", "o", "o", "o", "o"],
        ["o", "o", "o", "o", "o", "o", "o", "o", "o", "o", "o", "o", "o", "o", "o"],
        ["o", "o", "o", "o", "o", "o", "o", "o", "o", "o", "o", "o", "o", "o", "o"]
      ]
    },
    {
      "name": "Level 2: Checkerboard Shift",
      "map": [
        ["o", "x", "o", "x", "o", "x", "o", "x", "o", "x", "o", "x", "o", "x", "o"],
        ["x", "o", "x", "o", "x", "o", "x", "o", "x", "o", "x", "o", "x", "o", "x"],
        ["o", "x", "o", "x", "o", "x", "o", "x", "o", "x", "o", "x", "o", "x", "o"],
        ["x", "o", "x", "o", "x", "o", "x", "o", "x", "o", "x", "o", "x", "o", "x"],
        ["o", "x", "o", "x", "o", "x", "o", "x", "o", "x", "o", "x", "o", "x", "o"],
        ["x", "o", "x", "o", "x", "o", "x", "o", "x", "o", "x", "o", "x", "o", "x"],
        ["o", "x", "o", "x", "o", "x", "o", "x", "o", "x", "o", "x", "o", "x", "o"],
        ["o", "o", "o", "o", "o", "o", "o", "o", "o", "o", "o", "o", "o", "o", "o"],
        ["o", "o", "o", "o", "o", "o", "o", "o", "o", "o", "o", "o", "o", "o", "o"],
        ["o", "o", "o", "o", "o", "o", "o", "o", "o", "o", "o", "o", "o", "o", "o"],
        ["o", "o", "o", "o", "o", "o", "o", "o", "o", "o", "o", "o", "o", "o", "o"]
      ]
    },
    {
      "name": "Level 3: Pyramid Challenge",
      "map": [
        ["o", "o", "o", "o", "o", "o", "x", "o", "x", "o", "o", "o", "o", "o", "o"],
        ["o", "o", "o", "o", "x", "x", "x", "x", "x", "x", "x", "o", "o", "o", "o"],
        ["o", "o", "o", "x", "x", "x", "x", "x", "x", "x", "x", "x", "o", "o", "o"],
        ["o", "o", "x", "x", "x", "x", "x", "x", "x", "x", "x", "x", "x", "o", "o"],
        ["o", "x", "x", "x", "x", "x", "x", "x", "x", "x", "x", "x", "x", "x", "o"],
        ["x", "x", "x", "x", "x", "x", "x", "x", "x", "x", "x", "x", "x", "x", "x"],
        ["x", "x", "x", "x", "x", "x", "x", "x", "x", "x", "x", "x", "x", "x", "x"],
        ["o", "o", "o", "o", "o", "o", "o", "o", "o", "o", "o", "o", "o", "o", "o"],
        ["o", "o", "o", "o", "o", "o", "o", "o", "o", "o", "o", "o", "o", "o", "o"],
        ["o", "o", "o", "o", "o", "o", "o", "o", "o", "o", "o", "o", "o", "o", "o"],
        ["o", "o", "o", "o", "o", "o", "o", "o", "o", "o", "o", "o", "o", "o", "o"]
      ]
    },
    {
      "name": "Level 4: Tunnel Approach",
      "map": [
        ["x", "x", "x", "x", "x", "x", "x", "x", "x", "x", "x", "x", "x", "x", "x"],
        ["x", "o", "x", "x", "o", "o", "o", "o", "o", "o", "o", "x", "x", "o", "x"],
        ["x", "o", "x", "o", "o", "o", "o", "o", "o", "o", "o", "o", "x", "o", "x"],
        ["x", "o", "o", "o", "o", "o", "o", "o", "o", "o", "o", "o", "o", "o", "x"],
        ["x", "o", "x", "o", "o", "o", "o", "o", "o", "o", "o", "o", "x", "o", "x"],
        ["x", "o", "x", "x", "o", "o", "o", "o", "o", "o", "o", "x", "x", "o", "x"],
        ["x", "x", "x", "x", "x", "o", "o", "o", "o", "o", "x", "x", "x", "x", "x"],
        ["o", "o", "o", "o", "o", "o", "o", "o", "o", "o", "o", "o", "o", "o", "o"],
        ["o", "o", "o", "o", "o", "o", "o", "o", "o", "o", "o", "o", "o", "o", "o"],
        ["o", "o", "o", "o", "o", "o", "o", "o", "o", "o", "o", "o", "o", "o", "o"],
        ["o", "o", "o", "o", "o", "o", "o", "o", "o", "o", "o", "o", "o", "o", "o"]
      ]
    }
  ]
}