{
  "levels": [
    {
      "name": "Level 0: Test",
      "map": [
        ["o", "o", "o", "o", "o", "o", "o", "o", "o", "o", "o", "o", "o", "o", "o"],
        ["o", "o", "o", "o", "o", "o", "o", "o", "o", "o", "o", "o", "o", "o", "o"],
        ["o", "o", "o", "o", "o", "o", "o", "o", "o", "o", "o", "o", "o", "o", "o"],
        ["o", "o", "o", "o", "o", "o", "o", "o", "o", "o", "o", "o", "o", "o", "o"],
        ["o", "o", "o", "o", "o", "o", "o", "o", "o", "o", "o", "o", "o", "o", "o"],
        ["o", "o", "o", "o", "x", "o", "o", "o", "o", "o", "x", "o", "o", "o", "o"],
        ["o", "o", "o", "o", "o", "x", "o", "o", "o", "x", "o", "o", "o", "o", "o"],
        ["o", "o", "o", "o", "o", "o", "o", "o", "o", "o", "o", "o", "o", "o", "o"],
        ["o", "o", "o", "o", "o", "o", "o", "o", "o", "o", "o", "o", "o", "o", "o"],
        ["o", "o", "o", "o", "o", "o", "o", "o", "o", "o", "o", "o", "o", "o", "o"],
        ["o", "o", "o", "o", "o", "o", "o", "o", "o", "o", "o", "o", "o", "o", "o"]
      ]
    },
    {
      "name": "Level 1: Original",
      "map": [
        ["x", "o", "x", "o", "x", "o", "x", "o", "x", "o", "x", "o", "x", "o", "x"],
        ["o", "x", "o", "x", "o", "x", "o", "x", "o", "x", "o", "x", "o", "x", "o"],
        ["x", "o", "x", "o", "x", "o", "x", "o", "x", "o", "x", "o", "x", "o", "x"],
        ["o", "x", "o", "x", "o", "x", "o", "x", "o", "x", "o", "x", "o", "x", "o"],
        ["x", "o", "x", "o", "x", "o", "x", "o", "x", "o", "x", "o", "x", "o", "x"],
        ["o", "x", "o", "x", "o", "x", "o", "x", "o", "x", "o", "x", "o", "x", "o"],
        ["x", "o", "x", "o", "x", "o", "x", "o", "x", "o", "x", "o", "x", "o", "x"],
        ["o", "o", "o", "o", "o", "o", "o", "o", "o", "o", "o", "o", "o", "o", "o"],
        ["o", "o", "o", "o", "o", "o", "o", "o", "o", "o", "o", "o", "o", "o", "o"],
        ["o", "o", "o", "o", "o", "o", "o", "o", "o", "o", "o", "o", "o", "o", "o"],
        ["o", "o", "o", "o", "o", "o", "o", "o", "o", "o", "o", "o", "o", "o", "o"]
      ]
    },
    {
      "name": "Level 2: Checkerboard Shift",
      "map": [
        ["o", "x", "o", "x", "o", "x", "o", "x", "o", "x", "o", "x", "o", "x", "o"],
        ["x", "o", "x", "o", "x", "o", "x", "o", "x", "o", "x", "o", "x", "o", "x"],
        ["o", "x", "o", "x", "o", "x", "o", "x", "o", "x", "o", "x", "o", "x", "o"],
        ["x", "o", "x", "o", "x", "o", "x", "o", "x", "o", "x", "o", "x", "o", "x"],
        ["o", "x", "o", "x", "o", "x", "o", "x", "o", "x", "o", "x", "o", "x", "o"],
        ["x", "o", "x", "o", "x", "o", "x", "o", "x", "o", "x", "o", "x", "o", "x"],
        ["o", "x", "o", "x", "o", "x", "o", "x", "o", "x", "o", "x", "o", "x", "o"],
        ["o", "o", "o", "o", "o", "o", "o", "o", "o", "o", "o", "o", "o", "o", "o"],
        ["o", "o", "o", "o", "o", "o", "o", "o", "o", "o", "o", "o", "o", "o", "o"],
        ["o", "o", "o", "o", "o", "o", "o", "o", "o", "o", "o", "o", "o", "o", "o"],
        ["o", "o", "o", "o", "o", "o", "o", "o", "o", "o", "o", "o", "o", "o", "o"]
      ]
    },
    {
      "name": "Level 3: Pyramid Challenge",
      "map": [
        ["o", "o", "o", "o", "o", "o", "x", "o", "x", "o", "o", "o", "o", "o", "o"],
        ["o", "o", "o", "o", "x", "x", "x", "x", "x", "x", "x", "o", "o", "o", "o"],
        ["o", "o", "o", "x", "x", "x", "x", "x", "x", "x", "x", "x", "o", "o", "o"],
        ["o", "o", "x", "x", "x", "x", "x", "x", "x", "x", "x", "x", "x", "o", "o"],
        ["o", "x", "x", "x", "x", "x", "x", "x", "x", "x", "x", "x", "x", "x", "o"],
        ["x", "x", "x", "x", "x", "x", "x", "x", "x", "x", "x", "x", "x", "x", "x"],
        ["x", "x", "x", "x", "x", "x", "x", "x", "x", "x", "x", "x", "x", "x", "x"],
        ["o", "o", "o", "o", "o", "o", "o", "o", "o", "o", "o", "o", "o", "o", "o"],
        ["o", "o", "o", "o", "o", "o", "o", "o", "o", "o", "o", "o", "o", "o", "o"],
        ["o", "o", "o", "o", "o", "o", "o", "o", "o", "o", "o", "o", "o", "o", "o"],
        ["o", "o", "o", "o", "o", "o", "o", "o", "o", "o", "o", "o", "o", "o", "o"]
      ]
    },
    {
      "name": "Level 4",
      "map": [
        ["x", "o", "o", "o", "o", "o", "x", "o", "x", "o", "o", "o", "o", "o", "x"],
        ["x", "o", "x", "x", "x", "x", "x", "x", "x", "x", "x", "x", "x", "o", "x"],
        ["x", "o", "x", "o", "o", "x", "x", "o", "x", "x", "o", "o", "x", "o", "x"],
        ["x", "o", "o", "o", "o", "o", "o", "o", "o", "o", "o", "o", "o", "o", "x"],
        ["x", "o", "x", "x", "o", "o", "o", "o", "o", "o", "o", "x", "x", "o", "x"],
        ["x", "o", "x", "x", "x", "o", "x", "x", "x", "o", "x", "x", "x", "o", "x"],
        ["x", "x", "x", "x", "x", "x", "x", "x", "x", "x", "x", "x", "x", "x", "x"],
        ["o", "o", "o", "o", "o", "o", "o", "o", "o", "o", "o", "o", "o", "o", "o"],
        ["o", "o", "o", "o", "o", "o", "o", "o", "o", "o", "o", "o", "o", "o", "o"],
        ["o", "o", "o", "o", "o", "o", "o", "o", "o", "o", "o", "o", "o", "o", "o"],
        ["o", "o", "o", "o", "o", "o", "o", "o", "o", "o", "o", "o", "o", "o", "o"]
      ]
    },{
      "name": "Level 5: Central Column",
      "map": [
        ["o", "o", "o", "o", "o", "o", "x", "x", "x", "o", "o", "o", "o", "o", "o"],
        ["o", "o", "o", "o", "o", "o", "x", "x", "x", "o", "o", "o", "o", "o", "o"],
        ["o", "o", "o", "o", "o", "o", "x", "x", "x", "o", "o", "o", "o", "o", "o"],
        ["o", "o", "o", "o", "o", "o", "x", "x", "x", "o", "o", "o", "o", "o", "o"],
        ["o", "o", "o", "o", "o", "o", "x", "x", "x", "o", "o", "o", "o", "o", "o"],
        ["o", "o", "o", "o", "o", "o", "x", "x", "x", "o", "o", "o", "o", "o", "o"],
        ["o", "o", "o", "o", "o", "o", "x", "x", "x", "o", "o", "o", "o", "o", "o"],
        ["o", "o", "o", "o", "o", "o", "o", "o", "o", "o", "o", "o", "o", "o", "o"],
        ["o", "o", "o", "o", "o", "o", "o", "o", "o", "o", "o", "o", "o", "o", "o"],
        ["o", "o", "o", "o", "o", "o", "o", "o", "o", "o", "o", "o", "o", "o", "o"],
        ["o", "o", "o", "o", "o", "o", "o", "o", "o", "o", "o", "o", "o", "o", "o"]
      ]
    },
    {
      "name": "Level 6: Scattered",
      "map": [
        ["x", "o", "o", "x", "o", "o", "x", "o", "x", "o", "o", "x", "o", "o", "x"],
        ["o", "o", "x", "o", "x", "o", "o", "x", "o", "o", "x", "o", "x", "o", "o"],
        ["o", "x", "o", "o", "o", "x", "o", "o", "o", "x", "o", "o", "o", "x", "o"],
        ["x", "o", "o", "x", "o", "o", "x", "o", "x", "o", "o", "x", "o", "o", "x"],
        ["o", "o", "x", "o", "x", "o", "o", "x", "o", "o", "x", "o", "x", "o", "o"],
        ["o", "x", "o", "o", "o", "x", "o", "o", "o", "x", "o", "o", "o", "x", "o"],
        ["x", "o", "o", "x", "o", "o", "x", "o", "x", "o", "o", "x", "o", "o", "x"],
        ["o", "o", "o", "o", "o", "o", "o", "o", "o", "o", "o", "o", "o", "o", "o"],
        ["o", "o", "o", "o", "o", "o", "o", "o", "o", "o", "o", "o", "o", "o", "o"],
        ["o", "o", "o", "o", "o", "o", "o", "o", "o", "o", "o", "o", "o", "o", "o"],
        ["o", "o", "o", "o", "o", "o", "o", "o", "o", "o", "o", "o", "o", "o", "o"]
      ]
    },
    {
      "name": "Level 7: Columns",
      "map": [
        ["x", "o", "o", "x", "o", "o", "x", "o", "o", "x", "o", "o", "x", "o", "o"],
        ["x", "o", "o", "x", "o", "o", "x", "o", "o", "x", "o", "o", "x", "o", "o"],
        ["x", "o", "o", "x", "o", "o", "x", "o", "o", "x", "o", "o", "x", "o", "o"],
        ["x", "o", "o", "x", "o", "o", "x", "o", "o", "x", "o", "o", "x", "o", "o"],
        ["x", "o", "o", "x", "o", "o", "x", "o", "o", "x", "o", "o", "x", "o", "o"],
        ["x", "o", "o", "x", "o", "o", "x", "o", "o", "x", "o", "o", "x", "o", "o"],
        ["x", "o", "o", "x", "o", "o", "x", "o", "o", "x", "o", "o", "x", "o", "o"],
        ["o", "o", "o", "o", "o", "o", "o", "o", "o", "o", "o", "o", "o", "o", "o"],
        ["o", "o", "o", "o", "o", "o", "o", "o", "o", "o", "o", "o", "o", "o", "o"],
        ["o", "o", "o", "o", "o", "o", "o", "o", "o", "o", "o", "o", "o", "o", "o"],
        ["o", "o", "o", "o", "o", "o", "o", "o", "o", "o", "o", "o", "o", "o", "o"]
      ]
    },
    {
      "name": "Level 8: Corner Focus",
      "map": [
        ["x", "x", "x", "x", "x", "o", "o", "o", "o", "o", "x", "x", "x", "x", "x"],
        ["x", "x", "x", "x", "x", "o", "o", "o", "o", "o", "x", "x", "x", "x", "x"],
        ["x", "x", "x", "x", "o", "o", "o", "o", "o", "o", "o", "x", "x", "x", "x"],
        ["o", "o", "o", "o", "o", "o", "o", "o", "o", "o", "o", "o", "o", "o", "o"],
        ["o", "o", "o", "o", "o", "o", "o", "o", "o", "o", "o", "o", "o", "o", "o"],
        ["x", "x", "x", "x", "o", "o", "o", "o", "o", "o", "o", "x", "x", "x", "x"],
        ["x", "x", "x", "x", "x", "o", "o", "o", "o", "o", "x", "x", "x", "x", "x"],
        ["o", "o", "o", "o", "o", "o", "o", "o", "o", "o", "o", "o", "o", "o", "o"],
        ["o", "o", "o", "o", "o", "o", "o", "o", "o", "o", "o", "o", "o", "o", "o"],
        ["o", "o", "o", "o", "o", "o", "o", "o", "o", "o", "o", "o", "o", "o", "o"],
        ["o", "o", "o", "o", "o", "o", "o", "o", "o", "o", "o", "o", "o", "o", "o"]
      ]
    },
    {
      "name": "Level 9: Inverted Pyramid",
      "map": [
        ["x", "x", "x", "x", "x", "x", "x", "x", "x", "x", "x", "x", "x", "x", "x"],
        ["o", "x", "x", "x", "x", "x", "x", "x", "x", "x", "x", "x", "x", "x", "o"],
        ["o", "o", "x", "x", "x", "x", "x", "x", "x", "x", "x", "x", "x", "o", "o"],
        ["o", "o", "o", "x", "x", "x", "x", "x", "x", "x", "x", "x", "o", "o", "o"],
        ["o", "o", "o", "o", "x", "x", "x", "x", "x", "x", "x", "o", "o", "o", "o"],
        ["o", "o", "o", "o", "o", "x", "x", "x", "x", "x", "o", "o", "o", "o", "o"],
        ["o", "o", "o", "o", "o", "o", "x", "x", "x", "o", "o", "o", "o", "o", "o"],
        ["o", "o", "o", "o", "o", "o", "o", "o", "o", "o", "o", "o", "o", "o", "o"],
        ["o", "o", "o", "o", "o", "o", "o", "o", "o", "o", "o", "o", "o", "o", "o"],
        ["o", "o", "o", "o", "o", "o", "o", "o", "o", "o", "o", "o", "o", "o", "o"],
        ["o", "o", "o", "o", "o", "o", "o", "o", "o", "o", "o", "o", "o", "o", "o"]
      ]
    },
    {
      "name": "Level 10: Staircase",
      "map": [
        ["x", "o", "o", "o", "o", "o", "o", "o", "o", "o", "o", "o", "o", "o", "x"],
        ["x", "x", "o", "o", "o", "o", "o", "o", "o", "o", "o", "o", "o", "x", "x"],
        ["x", "x", "x", "o", "o", "o", "o", "o", "o", "o", "o", "o", "x", "x", "x"],
        ["x", "x", "x", "x", "o", "o", "o", "o", "o", "o", "o", "x", "x", "x", "x"],
        ["x", "x", "x", "x", "x", "o", "o", "o", "o", "o", "x", "x", "x", "x", "x"],
        ["x", "x", "x", "x", "x", "x", "o", "o", "o", "x", "x", "x", "x", "x", "x"],
        ["x", "x", "x", "x", "x", "x", "x", "o", "x", "x", "x", "x", "x", "x", "x"],
        ["o", "o", "o", "o", "o", "o", "o", "o", "o", "o", "o", "o", "o", "o", "o"],
        ["o", "o", "o", "o", "o", "o", "o", "o", "o", "o", "o", "o", "o", "o", "o"],
        ["o", "o", "o", "o", "o", "o", "o", "o", "o", "o", "o", "o", "o", "o", "o"],
        ["o", "o", "o", "o", "o", "o", "o", "o", "o", "o", "o", "o", "o", "o", "o"]
      ]
    },
    {
      "name": "Level 11: Hollow Square",
      "map": [
        ["x", "x", "x", "x", "x", "x", "x", "x", "x", "x", "x", "x", "x", "x", "x"],
        ["x", "o", "o", "o", "o", "o", "o", "o", "o", "o", "o", "o", "o", "o", "x"],
        ["x", "o", "x", "x", "x", "x", "x", "x", "x", "x", "x", "x", "x", "o", "x"],
        ["x", "o", "x", "o", "o", "o", "o", "o", "o", "o", "o", "o", "x", "o", "x"],
        ["x", "o", "x", "o", "o", "o", "o", "o", "o", "o", "o", "o", "x", "o", "x"],
        ["x", "o", "x", "o", "o", "o", "o", "o", "o", "o", "o", "o", "x", "o", "x"],
        ["x", "o", "x", "x", "x", "x", "x", "x", "x", "x", "x", "x", "x", "o", "x"],
        ["o", "o", "o", "o", "o", "o", "o", "o", "o", "o", "o", "o", "o", "o", "o"], 
        ["o", "o", "o", "o", "o", "o", "o", "o", "o", "o", "o", "o", "o", "o", "o"],
        ["o", "o", "o", "o", "o", "o", "o", "o", "o", "o", "o", "o", "o", "o", "o"],
        ["o", "o", "o", "o", "o", "o", "o", "o", "o", "o", "o", "o", "o", "o", "o"]
      ]
    },
    {
      "name": "Level 12: Checkered Gap",
      "map": [
        ["x", "x", "x", "x", "o", "o", "o", "o", "o", "o", "o", "x", "x", "x", "x"],
        ["x", "x", "x", "x", "o", "o", "o", "o", "o", "o", "o", "x", "x", "x", "x"],
        ["o", "o", "o", "o", "x", "o", "x", "o", "x", "o", "x", "o", "o", "o", "o"],
        ["o", "o", "o", "o", "o", "x", "o", "x", "o", "x", "o", "o", "o", "o", "o"],
        ["x", "x", "x", "x", "o", "o", "o", "o", "o", "o", "o", "x", "x", "x", "x"],
        ["x", "x", "x", "x", "o", "o", "o", "o", "o", "o", "o", "x", "x", "x", "x"],
        ["o", "o", "o", "o", "x", "o", "x", "o", "x", "o", "x", "o", "o", "o", "o"],
        ["o", "o", "o", "o", "o", "o", "o", "o", "o", "o", "o", "o", "o", "o", "o"],
        ["o", "o", "o", "o", "o", "o", "o", "o", "o", "o", "o", "o", "o", "o", "o"],
        ["o", "o", "o", "o", "o", "o", "o", "o", "o", "o", "o", "o", "o", "o", "o"],
        ["o", "o", "o", "o", "o", "o", "o", "o", "o", "o", "o", "o", "o", "o", "o"]
      ]
    },
    {
      "name": "Level 13: Random Chaos",
      "map": [
        ["x", "o", "o", "x", "x", "o", "x", "o", "o", "x", "x", "o", "x", "o", "o"],
        ["o", "x", "o", "o", "x", "x", "o", "x", "o", "o", "x", "x", "o", "x", "o"],
        ["o", "o", "x", "o", "o", "x", "x", "o", "x", "o", "o", "x", "x", "o", "x"],
        ["x", "o", "o", "x", "o", "o", "x", "x", "o", "x", "o", "o", "x", "x", "o"],
        ["o", "x", "o", "o", "x", "o", "o", "x", "x", "o", "x", "o", "o", "x", "x"],
        ["x", "o", "x", "o", "o", "x", "o", "o", "x", "x", "o", "x", "o", "o", "x"],
        ["o", "x", "o", "x", "o", "o", "x", "o", "o", "x", "x", "o", "x", "o", "o"],
        ["o", "o", "o", "o", "o", "o", "o", "o", "o", "o", "o", "o", "o", "o", "o"],
        ["o", "o", "o", "o", "o", "o", "o", "o", "o", "o", "o", "o", "o", "o", "o"],
        ["o", "o", "o", "o", "o", "o", "o", "o", "o", "o", "o", "o", "o", "o", "o"],
        ["o", "o", "o", "o", "o", "o", "o", "o", "o", "o", "o", "o", "o", "o", "o"]
      ]
    }    
  ]
}